AF=Afghanistan
AL=Albania
AG=Algeria
AX=American Samoa
AN=Andorra
AO=Angola
AV=Anguilla
AT=Antarctica
AC=Antigua and Barbuda
AR=Argentina
AM=Armenia
AA=Aruba
AS=Australia
AU=Austria
AJ=Azerbaijan
BF=Bahamas, The
BA=Bahrain
BG=Bangladesh
BB=Barbados
BO=Belarus
BE=Belgium
BH=Belize
BN=Benin
BD=Bermuda
BT=Bhutan
BL=Bolivia
BK=Bosnia and Herzegovina
BC=Botswana
BR=Brazil
BX=Brunei
BU=Bulgaria
UV=Burkina Faso
BM=Burma (Myanmar)
BY=Burundi
CB=Cambodia
CM=Cameroon
CA=Canada
CV=Cape Verde
CJ=Cayman Islands
CT=Central African Republic
CD=Chad
CI=Chile
CH=China
KT=Christmas Island
CK=Cocos (Keeling) Islands
CO=Colombia
CG=Congo, Democratic Republic of the
CF=Congo. Republic of the
CW=Cook Islands
CS=Costa Rica
IV=Cote d'Ivoire
HR=Croatia
CU=Cuba
CY=Cyprus
EZ=Czech Republic
DA=Denmark
DJ=Djibouti
DO=Dominica
DR=Dominican Republic
EC=Ecuador
EG=Egypt
ES=El Salvador
EK=Equatorial Guinea
ER=Eritrea
EN=Estonia
ET=Ethiopia
FO=Faroe Islands
FJ=Fiji
FI=Finland
FR=France
FG=French Guiana
FP=French Polynesia
GB=Gabon
GA=Gambia, The
GZ=Gaza Strip
GG=Georgia
GM=Germany
GH=Ghana
GI=Gibraltar
GR=Greece
GJ=Grenada
GU=Guam
GT=Guatemala
GK=Guernsey
GV=Guinea
GY=Guyana
HA=Haiti
HO=Honduras
HK=Hong Kong
HU=Hungary
IC=Iceland
IN=India
ID=Indonesia
IR=Iran
IZ=Iraq
EI=Ireland
IS=Israel
IT=Italy
JM=Jamaica
JA=Japan
JE=Jersey
JO=Jordan
KZ=Kazakhstan
KE=Kenya
KR=Kiribati
KU=Kuwait
KG=Kyrgyzstan
LA=Laos
LG=Latvia
LE=Lebanon
LT=Lesotho
LI=Liberia
LY=Libya
LS=Liechtenstein
LH=Lithuania
LU=Luxembourg
MK=Macedonia
MA=Madagascar
MI=Malawi
MY=Malaysia
MV=Maldives
ML=Mali
MT=Malta
RM=Marshall Islands
MR=Mauritania
MP=Mauritius
MX=Mexico
MD=Moldova
MN=Monaco
MG=Mongolia
MW=Montenegro
MO=Morocco
MZ=Mozambique
WA=Namibia
NP=Nepal
NT=Netherland Antilles
NL=Netherlands
NZ=New Zealand
NU=Nicaragua
NG=Niger
NI=Nigeria
NF=Norfolk Island
KN=North Korea
NO=Norway
MU=Oman
PK=Pakistan
PM=Panama
PP=Papua New Guinea
PA=Paraguay
PE=Peru
RP=Philippines
PL=Poland
PO=Portugal
PR=Puerto Rico
QA=Qatar
RO=Romania
RS=Russia
SH=Saint Helena
SC=Saint Kitts and Nevis
ST=Saint Lucia
VC=Saint Vincent and the Grenadines
SA=Saudi Arabia
SG=Senegal
SR=Serbia
SL=Sierra Leone
SN=Singapore
LO=Slovakia
SI=Slovenia
BP=Solomon Islands
SO=Somalia
SF=South Africa
KS=South Korea
SP=Spain
CE=Sri Lanka
SU=Sudan
NS=Suriname
WZ=Swaziland
SW=Sweden
SZ=Switzerland
SY=Syria
TW=Taiwan
TI=Tajikistan
TZ=Tanzania
TH=Thailand
TO=Togo
TN=Tonga
TD=Trinidad and Tobago
TS=Tunisia
TU=Turkey
TX=Turkmenistan
TK=Turks and Caicos Islands
TV=Tuvalu
UG=Uganda
UP=Ukraine
AE=United Arab Emirates
UK=United Kingdom
US=United States
UY=Uruguay
UZ=Uzbekistan
NH=Vanuatu
VE=Venezuela
VM=Vietnam
WF=Wallis and Futuna
WE=West Bank
YM=Yemen
ZA=Zambia
ZI=Zimbabwe
